########
#P.C...#
#####..#
#G.K.C.#
########
