##########
#P..C....#
#####.##.#
#G.K.C.A.#
##########
