######
#P..S#
#....#
#..S##
###G##