########
#P..#..#
#......#
###L####
#....#.#
####L###
#.#..G.#
########
