##########
#P....#..#
##.....ES#
#.#..#.L##
#....T...#
#.G.#.#..#
##..#....#
##########
