##########
#P...-...#
#........#
#...|.T..#
#........#
#........#
#.......G#
##########
