##########
#..P.#...#
#....#...#
####T#####
#......L.#
########.#
#...|....#
#-########
#A...S..A#
########.#
#...E....#
#G.......#
##########
