@medal_targets gold=10 silver=13
@enemy_path 0,0;0,-1;0,-2;0,-1;0,0
P.C..######
####.######
####..T...#
#########.#
###.##.L...
###.##.##.#
###.C.E..A#
###.#####.#
###S...K.|G
