#######
#..P#.#
#..L..#
##....#
#...G.#
#.....#
#######
