##########
#P.C..A.##
#####...##
#G.K.C..##
##########
