########
#P.#...#
##-###.#
#....|.#
######-#
#......#
#.....G#
########
