########
#....#.#
##P..#.#
####T###
#......#
##.#...#
#.....G#
########
