#######
#P.#..#
#..#..#
#..L..#
#.....#
#...G.#
#######