@medal_targets gold=7 silver=9
##########
#P..O..G##
##..##.L##
#...A..###
##########
