########
#.#G.#.#
#.#...##
#.###.E#
#.#..#P#
#.#....#
##...#.#
########
