@start_tick = 0
@medal_targets gold=29 silver=39
@enemy_path 0,0;1,0;1,1;0,1
@enemy_path 0,0;0,1;1,0;1,1
@enemy_path 0,0;1,0;1,1;0,1
@enemy_path 0,0;0,1;0,0;1,0
P.....O.....C......#C
#.##....##....##...#.
.........O...........
.#..C.#...###.#...#..
..ACA...C......EO....
.#.#............A|C..
.....A.....C.....A#..
.#..#.......AA....E..
..A...........CEC..O.
..###....A.......A.#.
...O......C...A#-.#E.
.##..A........O..||CA
.C........#.....A|KG#