###########
#P.C.....##
#####.#..##
#G.K.C.C.##
###########
