########
#.P..#.#
#....#.#
####T###
#......#
##.#...#
#.....G#
########
