###########
#P..C....##
#####.##.##
#G.K.C.AS##
###########
