#####....G
#####.####
#####-....
|####..##.
.T...A.##.
.#####.##.
P.........

@start_tick=0