@medal_targets gold=3 silver=5
##########
#P.C....##
#####.T.##
#G.K.C.A##
##########
