#######
#.#G#.#
#.#.#.#
#..-..#
#.#.#.#
#P#...#
#######