##########
#....#..##
#P.|.....#
#....#...#
#....#..##
#.#.###.G#
#...#.#.E#
##########
