##########
#...#...##
#.P..##..#
#.##...###
#..T#G.-##
##.......#
##.#..#..#
##########
