######
#P...#
#....#
#..S##
###G##