@medal_targets gold=8 silver=11
P..A...C#
.###.###.
C..A.K.G.
.##..###.
...A.....