##########
#P.......#
#........#
#..L.....#
#..L.....#
#........#
#.......G#
##########
