@medal_targets gold=6 silver=8
##########
#P..O...G#
##..###..#
#...A...##
##########
