###########
#P..C....##
#####.#..##
#G.K.CE..##
######C..##
###########
