@start_tick = 0
@medal_targets gold=34 silver=46
@phase_goal period=4 active=2
P....O.................
..|...#..|...###.O..###
...C..#....O.....A..KG#
......#.............###
...A.......A....A......
#.-....-...|..#...|....
#..........A.....A..AC.
#.....####....#|....|#.
####.........O..A....#.
#.....#.......A.|..A.#.
#.....#....A.........#.
#...A...A....|.A.A..C#.
#|..C.########.###.O...
#...A.........A.###.-..
###...###...###..C###..