############
#P.........#
#..L.......#
#..T.S.....#
#.....A..-.#
#..E......|#
#..........#
#.........G#
############
