@start_tick = 0
@medal_targets gold=24 silver=32
@enemy_path 0,0;1,0;1,1;0,2
@enemy_path 0,0;0,1;1,0;2,0
P....O...........S.
#.#..#.....##..###.
..#.O..............
...A..C...O........
S........C.E..O....
......A....C......#
.##.....C......###.
....A.............S
..................|
S.....A.OCE...CO.#.
...-...........|S#.
.##..##.....O...K..
....C..O....C..SKG.
