########
#P..-..#
###-####
#...|..#
####.|.#
#.....|#
#..G...#
########
