########
#P...#.#
####.###
#....#.#
#.E..#.#
#....#.#
####.###
#...G..#
########
