#########
#P......#
#.#######
#A..S..A#
#######.#
#.......#
#......G#
#########
