##########
#...#.|..#
##.......#
#..|G.#P.#
#.....##.#
##..##...#
#..#.#.###
##########
