########
#P.....#
######.#
#......#
#.####.#
#....E.#
#.##.#.#
#G.....#
########