#####
#P..#
###T#
###G#
#####
