#######
#P.#..#
#.#...#
#.#.#.#
#...#.#
##.#..#
#....G#
#######
