@start_tick = 0
@medal_targets gold=9 silver=13
P....O#####
#...#####O#
#.#.#####.#
#.#O#O....#
#.........#
#.#####.###
#O#####.###
#######...G
