########
#P..#..#
#...#..#
#....#.#
#.#....#
#.#..#.#
#..#..G#
########
