@medal_targets gold=8 silver=10
##########
#P..C...##
##...E..##
#G.K.C..##
##########
