##########
#P.......#
#........#
#...S....#
#...A....#
#........#
#.......G#
##########
