@medal_targets gold=9 silver=11
############
#P..C.....##
#####.#...##
#G.K.CE...##
######C...##
############
