#.A.-...
P....##.
#..#-##.
#..#.##.
##.TT.#.
####....
####|G##

@start_tick=-1