##########
#P...#...#
#....#...#
#....T...#
#....#...#
##.......#
#........#
#.......G#
##########
