##########
#P.......#
#........#
#...T....#
#........#
#........#
#.......G#
##########
