##########
#P.......#
#........#
#..E.T...#
#........#
#........#
#.......G#
##########
