@start_tick = 0
@medal_targets gold=12 silver=16
P....O#####
###.#######
###.O######
###.......O
......K...#
.......O..#
C..O.|....#
O#O.C....-#
#########G#