##########
#...#...##
#..#.P##.#
#..#....##
#.G......#
##E.....##
#....-.#.#
##########
