@medal_targets gold=12 silver=14
P..A.######
###.#.....#
###.#.A..-#
.L.........
....#..#..#
.####.A...#
......##G##

@start_tick=0