@medal_targets gold=5 silver=7
##########
#P.C....##
#####...##
#G.K.C..##
##########
