@start_tick = 0
@medal_targets gold=26 silver=35
P...O....#........S
.#...O....A.##..#..
.#.#..........#....
..C..............L.
S...##...A.....C.A.
..A......C..O..##..
....OA.......O....S
.##....A.....C..O#.
...A....A..O.....A.
.................L.
.#.C..........CS.#.
.##A..O...CO..A...K
.....AC..........KG
