@medal_targets gold=17 silver=23
################
#P...#####....##
##A....###.##.##
##.#.#.##....-##
##.#.#.##...K.G#
##...C..A.##..##
####.#A...C..-##
####..C.AA..|.##
################