##########
#.#.G..#.#
#........#
#.....#.##
##.S.....#
#T.......#
#P.....###
##########
