########
#P.A..##
#....-.#
###T####
#..L...#
#.S..#G#
########