@start_tick=-1
@medal_targets gold=7 silver=9
#########
#P..O.TG#
##..##..#
#...A..##
#########
