@start_tick = 0
@medal_targets gold=30 silver=40
@phase_goal period=4 active=2
#######################
#P....A....#######G####
#.###.###..#..####K####
#...C...#..#..#.......#
###.###.#..#..#.##.##.#
#.....#.#.....#...A...#
#.###.#.#####.###.###.#
#.#...A.....#...#.....#
#.#.#######.#.#.#####.#
#C#.....#...#.#......T#
#.#####.#.###.#######.#
#.....A.#.....C...A...#
#.###.#####.#####.###.#
#...#.............#...#
#######################