@medal_targets gold=9 silver=11
@enemy_path 0,0;0,1;1,1;1,0
P..A-......
.....G.|T.A
...L.....E.
.##A...A...
.##...#....
.##...#....
.##.#.#S...
....#.##..#