#######
#..P..#
#..A..#
###T###
###.###
###G###
#######