@start_tick = 0
@medal_targets gold=18 silver=28
@phase_goal period=4 active=2
@enemy_path 0,1;0,1;0,0;0,1
#####################
#...................#
#..#..#...........#.#
#.####A...G.E...A####
#..#..............#.#
#...................#
#......#...###...##.#
#......#...#........#
#...A.....|..A......#
#...................#
#.#.........#.......#
##P...A-.....A..A...#
#.#-A.|...A.##......#
#.#.#......###......#
#####################