########
#P..#..#
#......#
###L####
#....#.#
####L###
#.#....#
#.....G#
########
