########
#P.....#
#......#
#..#...#
#......#
#.....G#
########
